*********
*********
B*B***B**
B***B***B
**B*****B
****BBB**
**B******
******B**
B********